XXXOOOOX
OXXXOXOE
OXXOOXXO
OSXOXXXO
XOOOXOOO